11111111111111111
1010P1110011C0001
1011EC000C0100101
1010100C100000001
11000101101010001
11C0C10C110100101
11111111111111111