11111111111
101100E1C11
10001C1C001
101000100C1
1000P110101
101011000C1
10001101101
1100C000001
10100001101
101C1110011
11111111111