11111111111111111111111111111111111111111
10001001000C00100001C01010100CC00CC101C01
1000101010100000000C011010000101001000C11
1011101C000011010C0CC10100000000000C11101
1000P10000010CC00110CC0000010000001001111
1001110010010000100C101000001001100000011
10000001010010010011010010000000010001001
10100000C1010000000111010000110C110101111
1001CC010000101000010010C11010000011C0001
10010000000C000C00010000001C1000000100E11
11111111111111111111111111111111111111111